%%%%%%%%%%%%%%%%%%%%%%%%%%%%
%             .  %       . %
%                          %
%  .     P.............    %
%%%%%%%%%%%%%%%%%%%%%%%%%%%%
