%%%%%%%%%%%%%%%%%%%%%%%%%%%%
%                %       . %
%     %o G                 %
%    .%Po G                %
%%%%%%%%%%%%%%%%%%%%%%%%%%%%
