%%%%%%%%%%%%%%%%%%%%
%                  %
%      %           %
% .....%P......... %
%%%%%%%%%%%%%%%%%%%%
