%%%%%%%%%%%%%%%%%%%%
% .           .    %
%      %           %
%  ....%P......... %
%%%%%%%%%%%%%%%%%%%%
